...........#..#...........
...........#..#...........
..##..##...####...##..##..
..##..##..........##..##..
..##..##..........##..##..
..##..##..##..##..##..##..
..##..##..##..##..##..##..
..##..##..######..##..##..
..........######..........
..........##..##..........
@@..####..........####..@@
##..####..........####..##
..........##..##..........
..........##..##..........
..##..##..##@@##..##..##..
..##..##..##@@##..##..##..
..##..##..##..##..##..##..
..##..##..........##..##..
..##..##..........##..##..
..........##..##..........
..........##..##..........
##..####..........####..##
@@..####..........####..@@
..........##..##..........
..........######..........
..##..##..######..##..##..
